response	text
怎么了呀，有什么问题都跟我讲，后续有其他问题还可以来找我哦	没心情玩了
是遇到什么问题了嘛，可以和我说说的	没心情玩了
怎么了呀，是遇到什么问题了吗？	没心情玩了
怎么了呀	没心情玩了
是遇到什么问题了嘛	没心情玩了
哥，您消消气哈，我们也是希望游戏里有良好的游戏环境，能够尽量爆出自己想要的装备，装备的淘气是最重要的	没心情玩了
哥是觉得哪方面有恶意的地方呢，可以跟我说说的	你这服麻痹很恶心，你出啥活动都没意义，没啥人弄得，这服被你们设计的弄死了，第一次见那么恶心的服，麻痹到死动都动不了，早也不投资了，一分都不给了
哥，您消消气哈，游戏内的玩法都是随机的，并不是说充值多少就一定能获得想要的装备，您这边有什么好的建议，可以跟我说说，我帮您进行反馈，希望能让您开心	你这服麻痹很恶心，你出啥活动都没意义，没啥人弄得，这服被你们设计的弄死了，第一次见那么恶心的服，麻痹到死动都动不了，早也不投资了，一分都不给了
哥您消消气，您这边有什么建议都是可以跟我说的，我们也是一直在优化游戏的运营和维护方面的	你这服麻痹很恶心，你出啥活动都没意义，没啥人弄得，这服被你们设计的弄死了，第一次见那么恶心的服，麻痹到死动都动不了，早也不投资了，一分都不给了
哥您消消气，您具体是遇到什么问题了呢，请详细描述下，待专属客服上线后帮您解答~	你这服麻痹很恶心，你出啥活动都没意义，没啥人弄得，这服被你们设计的弄死了，第一次见那么恶心的服，麻痹到死动都动不了，早也不投资了，一分都不给了
哥是觉得游戏里的玩法太恶心了嘛	你这服麻痹很恶心，你出啥活动都没意义，没啥人弄得，这服被你们设计的弄死了，第一次见那么恶心的服，麻痹到死动都动不了，早也不投资了，一分都不给了
您先消消气，我们游戏确实没有单独修改某一个玩家数据的操作呢，您做为我们的忠实玩家，我们肯定是希望您在游戏中获取一个很好的体验的。确实这个东西不受人为控制，妹妹妹也能理解的，一直接触发展现，妹妹妹妹的运气，实力，这么，这个啥时候不见过度，妹妹妹的没啥，妹妹妹妹的，妹妹，妹妹妹，啥的	你这服麻痹很恶心，你出啥活动都没意义，没啥人弄得，这服被你们设计的弄死了，第一次见那么恶心的服，麻痹到死动都动不了，早也不投资了，一分都不给了
合区都是根据情况不定时来进行的呢	我们区就跟单机一样
合区都是根据区服整体来安排，优先考虑邻近区服，您如果对合区有什么需求都是可以提的，策划那边也会合理参考	我们区就跟单机一样
合区都是运营根据游戏整体生态区服真实情况安排，可能部分区服安排不会那么完美，大家可以将合区提交建议，具体合区还是要看运营那边的安排，我们会尽量为大家反馈的哦~	我们区就跟单机一样
跨服的话，系统是根据区服的综合情况来安排的，在周二最后的时候都是会重新匹配	我们区就跟单机一样
跨服里面的资源比较强的话也是可以去对应的转生地图的，不一定要都一样，也可以打到材料	我们区就跟单机一样
单机两个月，不要充值	我们区就跟单机一样
目前线下设置的累充福利档位是1##k、3##k、5k、1##w、2##w、3##w、5##w等等这些的，您达到充值档位后，提供下区服和对应的角色等人专属工客服上班后为您申请	领下累充礼包
目前线下设置的累充福利档位是1##k、3##k、5k、1##w、2##w、3##w、5##w等等这些的，您达到充值档位后，等人工客服上班后为您申请	领下累充礼包
目前档位礼包分别为：1千、2千、5千、8千、1##w、3##w、5##w，当前档位礼包查询可第二日咨询人工客服进行核实是否达到条件。	领下累充礼包
目前线下设置的累充福利档位是1##k、3##k、5k、1##w、2##w、3##w、5##w等等这些的，您达到充多少可以申请累充礼包	领下累充礼包
您是说游戏内的累充礼包么？这个是累充1##w的福利礼包，您角色充值达到3##w后可以再找我申请一个	领下累充礼包
目前线下设置的累充福利档位是1##k、3##k、5k、1##w、2##w、3##w、5##w等等这些的	领下累充礼包
好的，我提交技术核实处理一下	1316区剑指疯狂
好的，这些礼包哥没有领取的话，可以复制到福利大厅进行兑换试试，稍等，我先看下您的福利情况这边还在申请中，您后续有其他问题还可以来找我	1316区剑指疯狂
好的，这些礼包哥没有领取的话，可以复制到福利大厅进行兑换试试，稍等，我先看下您的专属福利	1316区剑指疯狂
好的，这些礼包哥没有领取的话，可以在系统设置-礼包码那里领取，这些礼包您可以在游戏内福利大厅里兑换试试，稍等，我先看下您的专属福利	1316区剑指疯狂
"好的，这些礼包哥没有领取的话，可以在系统设置-礼包码内兑换，稍等，我先看下您的专属福利还有个问卷福利礼包，需要填写下问卷，哥有空可以填下，提交后记得截图发给我~，为了您的账号安全，避免忘记密码、账号丢失无法找回等情况，请您一定不要更换抖音账号且抖音账号不要更换手机号码如果抖音切换账号和更换过手机号码就会登陆续费是1..6万档位小额大额大额充值1##w,填写1##w,填写1.apk"	1316区剑指疯狂
查询到该角色在游戏中存在违规词汇而被系统进行了处理，这个无法解除，请您在游戏中尽量避免哦	1316区剑指疯狂
目前专属客服已下线，请提供下角色信息，待专属客服上线后会第一时间帮您看的喔~	昨天我又充了3000，美女你查下
目前专属客服已下线，请提供下角色信息，待专属客服上线后会第一时间帮您查询的喔~	昨天我又充了3000，美女你查下
哥，我这边是无法查询到您的充值记录的，麻烦您提供一下该账号最近3笔充值订单截图，以及绑定手机号，第二天提交人工客服为您查询核实	昨天我又充了3000，美女你查下
哥您可以提供下您的账号，我帮您查询下累充礼包哦	昨天我又充了3000，美女你查下
哥，我们游戏充值档位礼包是1##k、3##k、5k、1##w、2##w、3##w、5##w、10##w、15##w，您达到对应的充值可以发一下您的区服和角色名，白天专属客服帮您查询看看是否有可以使用的礼包	昨天我又充了3000，美女你查下
哥，我们当前确实是没有充值优惠和折扣的，这个是每一个玩家都相同的呀	昨天我又充了3000，美女你查下
您说的锁屏挂机具体是指什么呢？	建议可以锁屏挂机
您说的锁屏挂机是指的什么意思呀，游戏内的玩家行为都是会进行自动检测的	建议可以锁屏挂机
我这边会反映给技术进行处理的哦，不过具体的话还是要看技术那边的安排的哈	建议可以锁屏挂机
我们游戏主要是手游，暂时没有办法	建议可以锁屏挂机
我们这边的话是没有制作过第三方挂机的系统，但是这个我们也是不能进行干涉的，所以我们也是不了解玩家在游戏内具体的操作情况的。	建议可以锁屏挂机
这个已经反馈过了，后面说不定会改动呢	建议可以锁屏挂机
目前档位礼包分别为：1千、2千、5千、8千、1##w、3##w、5##w，当前档位礼包查询可第二日咨询人工客服进行核实是否达到条件。	我冲到了 你睡醒了给我发礼包码
目前礼包就是日常通用礼包和专属充值档位礼包，有1##k、3##k、5k、1##w、2##w、3##w、5##w、10##w、15##w、20##w，您达到对应的充值可以发一下您的区服和角色名，上班后专属客服帮您查询看看是否有可以使用的礼包	我冲到了 你睡醒了给我发礼包码
目前暂时没有新的礼包码了，后续有新的福利和活动也会及时通知您的	我冲到了 你睡醒了给我发礼包码
您好，我是夜间机器人小灵。月度礼包[礼物]，周度礼包[礼物]	我冲到了 你睡醒了给我发礼包码
您好，我是夜间机器人小灵。哥，礼包码请查收[玫瑰]	我冲到了 你睡醒了给我发礼包码
我来了	我冲到了 你睡醒了给我发礼包码
哥您是遇到什么问题了嘛，跨服的话是根据区服整体来安排，优先考虑邻近区服，您如果对于跨服有什么想法的话都是可以提的，策划那边也会合理参考	今天的跨服怎么这么多个区跨服，让不让人玩了
跨服匹配是根据区服内的综合实力进行匹配的，在目标区服满足合区条件后，会尽快安排合区，同时随着游戏的更新多出新的跨服活动和后续的活动肯定也是会考虑玩家的情况的	今天的跨服怎么这么多个区跨服，让不让人玩了
您先消消气，这个问题帮您提交给相关部门核实处理，您后续还是可以通过游戏内的情况进行判断	今天的跨服怎么这么多个区跨服，让不让人玩了
跨服的话都是随机进行匹配的哈，所以也是有可能会匹配到很多区服的，所以会稍微晚点再进行匹配，您可以先打打看的	今天的跨服怎么这么多个区跨服，让不让人玩了
哥您具体是遇到了什么问题呀~	今天的跨服怎么这么多个区跨服，让不让人玩了
跨服匹配的是哪个区呢	今天的跨服怎么这么多个区跨服，让不让人玩了
您先消消气，合区也希望能让每个区匹配到最符合的综合战力，但也往往并不会有完全或者相差不大的综合战力。能够进行合区的，都是各方面目前选择下做的最好的选择。	尼玛 几个区结盟干不过人家几个人 还怎么玩
您好，合区是根据各个区服实际情况做出的综合匹配调整，在目标区服满足合区条件后，会尽快安排合区，同时随着合区次数增多，所需时间也会增多，所以需要排期也会更久（包括下周三也会进行合区）	尼玛 几个区结盟干不过人家几个人 还怎么玩
哥您可以详细说一下您的意见和建议吗，我们的更新玩法是按照一个综合情况匹配的	尼玛 几个区结盟干不过人家几个人 还怎么玩
您先别急，合区维护时间延长了，发布了公告呢	尼玛 几个区结盟干不过人家几个人 还怎么玩
您好，合区并不是固定的，所以需要考虑当前的合服情况，同时帮您进行登记	尼玛 几个区结盟干不过人家几个人 还怎么玩
哥您别着急，合区维护时间延长了，发布了公告呢	尼玛 几个区结盟干不过人家几个人 还怎么玩
可能是触发了敏感词汇，系统自动进行禁言的，后续尽可能的优化，时间到了会自动解除	不管发什么都是说敏感词
可以截图给我看看吗	不管发什么都是说敏感词
可能是发言太多了，所以会存在系统监测到敏感词汇，我帮您去和技术说下	不管发什么都是说敏感词
可能会存在一些敏感词汇，您可以在游戏内多留意一下	不管发什么都是说敏感词
不会的，系统自动禁言的	不管发什么都是说敏感词
不会的敏感词的话，系统都会自动识别的	不管发什么都是说敏感词
可以在游戏内发言看下的，有显示什么可以截图或者录屏发给我看下	我怎么不能在游戏里面打字了？
可以发言的时候显示的是什么呢	我怎么不能在游戏里面打字了？
看看是不是发了联系方式呢	我怎么不能在游戏里面打字了？
可以发言的呀发言的时候是会有提示的	我怎么不能在游戏里面打字了？
可以打出来的哦	我怎么不能在游戏里面打字了？
可以打字说明呀	我怎么不能在游戏里面打字了？
建议您不要在游戏内发数字、联系方式等，检测到会被禁言，正常聊天是可以的	为什么不能说话
请问您说的不能说话是有什么显示吗，方便提供下录屏吗	为什么不能说话
请您提供下区服角色名帮您核实	为什么不能说话
请提供区服角色名帮您核实	为什么不能说话
您好，请问有什么可以帮您	为什么不能说话
请您提供下以下信息，核实后帮您申请礼包哦~	为什么不能说话
您消消气，合区肯定会重新匹配的，也是希望能让各位玩家满意的	操你妈的，和你妈区，意思
哥您消消气哈，您具体是什么问题呢，请详细描述下，待专属客服上线后帮您解答~	操你妈的，和你妈区，意思
哥消消气，游戏的概率每个玩家都是一样的，这个其实很公平，运营这边也是综合考虑了很久的，您不要着急，后面我们也是会进行合理参考每一位玩家的建议的，也希望把好运都分享给你的	操你妈的，和你妈区，意思
您消消气，您具体是什么问题呢，请详细描述下，待专属客服上线后帮您解答~	操你妈的，和你妈区，意思
亲这个游戏内的玩法操作这个我们都是无法去干预的呢	操你妈的，和你妈区，意思
哥，您消消气哈，目前该玩家已经做禁言处理啦	操你妈的，和你妈区，意思
哥您是在哪里看到的这个申请会员礼包呀，我去帮哥看看的	申请会员礼物真费劲
哥，您指的是什么礼物呀[撇嘴]	申请会员礼物真费劲
礼物只是一个辅助作用啦，并不会对您的游戏属性造成很大的影响，如果真的跟游戏一样大量的放送，这样有失公平性，您加上专属客服，我们提供给您的服务也是一种附加福利嘛	申请会员礼物真费劲
礼包只是一个辅助作用啦，并不会对您的游戏属性造成很大的影响，如果真的跟游戏一样大量的放送，这样有失公平性，您加上专属客服，我们提供给您的服务也是一种附加福利嘛	申请会员礼物真费劲
礼包只是一个额外的心意啦建议您理性消费哦	申请会员礼物真费劲
这是为您申请的问卷礼包哦~	申请会员礼物真费劲
您的这个问题客服这边也是帮您沟通过很多次了的，确实这个问题目前没有办法给您一个准确回复，因为游戏内的操作是不可逆的，所以是没有权限给您进行返回操作的。	我那个解除一直没成功，技术来了，你问问他们有没有解决办法
哥这个我问问技术，稍等一下，哥这个是因为系统误操作的情况没办法恢复的，所以这个我们这边测试是没有办法恢复的	我那个解除一直没成功，技术来了，你问问他们有没有解决办法
哥，技术这边核实到您的账号是正常游戏行为，没有获取钻石的途径，您可以使用其他途径进行游戏	我那个解除一直没成功，技术来了，你问问他们有没有解决办法
这边咨询到是因为手机系统缓存过多，导致的断线，需要重新登录，您看看是否可以正常登录	我那个解除一直没成功，技术来了，你问问他们有没有解决办法
这个我们游戏你需要保留相关的聊天记录才能进行申诉，你看看是否可以找到你想要的装备	我那个解除一直没成功，技术来了，你问问他们有没有解决办法
您这个情况的话可以尝试联系下原号主，让原号主找他要下最新的礼包码，这个是游戏内的设置，没有办法更改的，如果您有可以联系的原号主，也可以尝试联系下原号主的	我那个解除一直没成功，技术来了，你问问他们有没有解决办法
哥您可以截图一下您未到账的充值订单哈，到第二天您的专属客服好帮您提交给技术部门核实，同时您也是注意一下钻石变化，可能存在延时到账的情况	充钱为什么不到账
目前专属客服已下线，请提供下截图/视频，待专属客服上线后会第一时间帮您解决的喔~或者先大退重启看看	充钱为什么不到账
目前专属客服已下线，请提供下角色信息和订单截图，待专属客服上线后会第一时间帮您查询的喔~	充钱为什么不到账
哥，您是说什么充值不到账呢，麻烦详细描述下您的问题呢	充钱为什么不到账
您好，请提供充值的区服角色名帮您核实	充钱为什么不到账
您说的不到账是指的什么呢	充钱为什么不到账
